"filename", "language", "HTML", "CSS", "comment", "blank", "total"
"d:\Github\redstoneart-server.github.io\css\layout\figure-with-swiper.main.css", "CSS", 0, 3, 0, 0, 3
"d:\Github\redstoneart-server.github.io\css\layout\figure-with-swiper\figure.css", "CSS", 0, 94, 0, 14, 108
"d:\Github\redstoneart-server.github.io\css\layout\figure-with-swiper\swiper-content.css", "CSS", 0, 12, 0, 3, 15
"d:\Github\redstoneart-server.github.io\css\layout\figure-with-swiper\swiper.css", "CSS", 0, 3, 0, 0, 3
"d:\Github\redstoneart-server.github.io\css\layout\hover.main.css", "CSS", 0, 1, 0, 0, 1
"d:\Github\redstoneart-server.github.io\css\layout\hover\Grow-Shadow.css", "CSS", 0, 16, 1, 0, 17
"d:\Github\redstoneart-server.github.io\css\layout\pages.main.css", "CSS", 0, 4, 0, 0, 4
"d:\Github\redstoneart-server.github.io\css\layout\pages\about-us.css", "CSS", 0, 58, 0, 3, 61
"d:\Github\redstoneart-server.github.io\css\layout\pages\core-members.css", "CSS", 0, 32, 0, 5, 37
"d:\Github\redstoneart-server.github.io\css\layout\pages\join-us.css", "CSS", 0, 24, 0, 3, 27
"d:\Github\redstoneart-server.github.io\css\layout\pages\past-to-now.css", "CSS", 0, 23, 0, 3, 26
"d:\Github\redstoneart-server.github.io\css\layout\typed.css", "CSS", 0, 3, 0, 0, 3
"d:\Github\redstoneart-server.github.io\css\main.css", "CSS", 0, 32, 1, 6, 39
"d:\Github\redstoneart-server.github.io\index.html", "HTML", 155, 0, 7, 1, 163
"Total", "-", 155, 305, 9, 38, 507